22 40
0 0 0 0 0 0 0 0 0 0 0 0 0 0 0 0 0 0 0 0 0 0 0 0 0 0 0 0 0 0 0 0 0 0 0 0 0 0 0 0
0 2 2 2 2 2 2 2 2 2 1 1 1 1 3 1 3 1 1 3 1 1 1 1 1 1 1 1 3 1 2 2 2 2 2 2 2 2 2 0
0 5 5 5 5 5 5 5 5 5 1 1 1 1 1 1 1 1 1 1 1 3 1 1 1 1 3 1 1 1 5 5 5 5 5 5 5 5 5 0
0 5 5 4 11 5 5 5 5 5 1 1 3 1 1 1 1 1 1 1 1 1 1 3 1 1 1 3 1 1 5 5 5 5 5 11 4 5 5 0
0 2 2 2 2 2 2 2 2 2 1 1 3 1 1 1 1 1 1 1 1 3 1 1 1 1 1 1 3 1 2 2 2 2 2 2 2 2 2 0
0 5 5 5 5 5 5 5 5 5 1 1 1 1 1 1 3 1 1 1 3 1 1 1 1 1 1 1 3 1 5 5 5 5 5 5 5 5 5 0
0 5 5 4 11 5 5 5 5 5 1 1 1 1 3 1 1 1 1 1 1 3 1 3 3 1 1 1 1 1 5 5 5 5 5 11 4 5 5 0
0 2 2 2 2 2 2 2 2 2 1 3 3 1 1 1 1 1 1 1 1 3 1 3 3 1 1 1 1 1 2 2 2 2 2 2 2 2 2 0
0 5 5 5 5 5 5 5 5 5 1 1 1 1 3 1 3 1 1 1 1 3 1 1 3 1 1 1 1 1 5 5 5 5 5 5 5 5 5 0
0 5 5 4 11 5 5 5 5 5 1 1 1 1 3 1 3 1 1 1 1 3 1 1 3 1 1 3 1 1 5 5 5 5 5 11 4 5 5 0
0 2 2 2 2 2 2 2 2 2 1 3 3 1 3 1 1 3 1 1 1 1 3 1 1 1 3 1 1 1 2 2 2 2 2 2 2 2 2 0
0 5 5 5 5 5 5 5 5 5 1 3 3 1 3 1 1 3 1 1 1 1 1 1 1 1 1 1 1 1 5 5 5 5 5 5 5 5 5 0
0 5 5 4 11 5 5 5 5 5 1 1 1 1 3 1 1 3 1 1 1 1 1 1 1 1 3 1 1 1 5 5 5 5 5 11 4 5 5 0
0 2 2 2 2 2 2 2 2 2 1 1 1 1 1 3 1 1 1 3 1 1 1 1 3 1 1 3 1 1 2 2 2 2 2 2 2 2 2 0
0 1 1 1 1 3 1 3 1 1 3 1 1 1 1 1 1 1 1 3 1 1 1 1 1 3 1 1 1 1 1 1 1 1 1 1 1 1 3 0
0 1 1 1 1 1 1 3 1 1 1 1 3 1 1 1 1 3 1 1 3 1 3 1 1 1 3 1 1 3 1 1 1 1 1 1 1 1 1 0
0 1 1 3 1 1 1 1 3 1 1 1 1 1 3 1 1 1 3 1 1 1 1 1 1 1 3 1 1 3 1 1 1 1 1 1 1 1 1 0
0 1 1 3 1 1 1 1 1 1 1 1 3 1 1 1 1 1 1 3 1 3 3 1 1 1 1 1 1 1 1 1 3 1 1 1 1 1 1 0
0 3 1 10 1 1 1 3 1 1 1 1 1 1 1 1 1 1 1 3 1 3 3 1 1 1 1 1 1 1 1 1 3 3 1 1 3 1 6 0
0 1 1 1 1 3 1 1 1 1 1 1 3 1 3 3 1 1 1 1 1 1 3 1 1 1 1 1 1 1 1 3 1 1 3 1 1 1 1 0
0 3 3 1 1 1 1 1 1 1 1 1 3 1 3 3 1 1 1 1 1 1 1 1 1 3 1 1 3 1 3 1 3 1 1 3 1 1 1 0
0 0 0 0 0 0 0 0 0 0 0 0 0 0 0 0 0 0 0 0 0 0 0 0 0 0 0 0 0 0 0 0 0 0 0 0 0 0 0 0