22 40
0 0 0 0 0 0 0 0 0 0 0 0 0 0 0 0 0 0 0 0 0 0 0 0 0 0 0 0 0 0 0 0 0 0 0 0 0 0 0 0
0 1 3 1 1 3 1 1 2 1 3 1 1 1 4 1 2 1 1 1 5 1 3 1 2 3 1 1 1 1 1 1 2 1 1 3 3 1 1 0
0 1 1 1 1 1 1 1 2 1 1 1 1 1 1 3 2 3 3 1 5 1 1 1 2 5 1 1 4 1 1 1 2 1 1 1 1 3 1 0
0 5 5 5 5 5 5 5 5 5 5 5 5 5 5 5 5 5 5 5 5 5 5 5 5 5 5 5 5 5 5 5 5 5 5 5 5 5 5 0
0 4 1 1 1 1 1 1 2 1 3 1 1 1 1 3 2 1 3 1 5 1 1 5 2 1 1 3 1 1 4 1 2 1 1 3 1 3 1 0
0 1 1 1 1 1 1 1 2 1 3 1 1 1 1 3 2 1 3 1 5 3 1 1 2 1 1 1 1 1 3 1 2 1 1 1 5 1 1 0
0 2 2 2 2 2 2 2 2 2 2 2 2 2 2 2 2 2 2 2 5 2 2 2 2 2 2 2 2 2 2 2 2 2 2 2 2 2 2 0
0 1 1 1 1 3 3 1 2 1 1 3 1 1 1 1 2 1 1 1 5 1 1 3 2 1 1 1 1 3 1 1 2 1 1 1 1 1 3 0
0 1 1 1 1 1 1 1 2 1 1 5 1 1 1 1 2 1 1 1 5 1 1 1 2 1 1 1 1 3 1 5 2 1 1 1 1 1 3 0
0 5 5 5 5 5 5 5 5 5 5 5 5 5 5 5 5 5 5 5 5 5 5 5 5 5 5 5 5 5 5 5 5 5 5 5 5 5 5 0
0 3 1 1 3 1 1 1 2 1 1 1 1 3 1 1 2 1 1 3 5 1 1 1 2 1 1 1 1 1 1 4 2 3 1 1 1 1 1 0
0 3 1 1 1 1 3 1 2 1 1 3 1 1 3 1 2 1 1 1 5 1 5 3 2 1 1 1 1 1 1 1 2 3 1 1 1 3 1 0
0 1 3 1 1 1 1 1 2 1 1 1 3 1 1 1 2 1 1 1 5 1 5 3 2 1 1 1 1 1 1 1 2 5 3 1 1 3 1 0
0 2 2 2 2 2 2 2 2 2 2 2 2 2 2 2 2 2 2 2 5 2 2 2 2 2 2 2 2 2 2 2 2 2 2 2 2 2 2 0
0 3 1 5 5 11 1 1 2 1 1 1 1 3 1 3 2 1 1 1 5 1 1 1 2 1 3 4 1 1 3 1 2 1 1 1 1 1 1 0
0 1 1 1 1 1 3 1 2 3 1 1 1 1 1 1 2 1 1 4 5 1 1 1 2 5 1 1 3 1 1 1 2 1 3 1 3 3 1 0
0 5 5 5 5 5 5 5 5 5 5 5 5 5 5 5 5 5 5 5 5 5 5 5 5 5 5 5 5 5 5 5 5 5 5 5 5 5 5 0
0 4 1 1 5 1 3 1 2 3 1 1 1 1 3 1 2 1 3 1 5 1 1 3 2 1 3 1 3 1 1 1 2 1 1 1 1 1 1 0
0 1 1 1 1 1 3 1 2 3 1 1 4 1 1 1 2 1 1 1 5 3 1 1 2 1 1 3 1 1 1 1 2 1 1 1 3 3 5 0
0 1 4 1 1 1 5 3 2 1 1 3 1 1 1 1 2 1 10 4 5 3 1 1 2 1 5 1 1 1 1 1 2 1 1 1 3 3 5 0
0 1 3 1 1 1 1 5 2 1 1 5 1 1 3 1 2 1 6 1 5 1 1 1 2 1 1 1 1 3 1 3 2 1 1 1 1 5 1 0
0 0 0 0 0 0 0 0 0 0 0 0 0 0 0 0 0 0 0 0 0 0 0 0 0 0 0 0 0 0 0 0 0 0 0 0 0 0 0 0
