22 40
0 0 0 0 0 0 0 0 0 0 0 0 0 0 0 0 0 0 0 0 0 0 0 0 0 0 0 0 0 0 0 0 0 0 0 0 0 0 0 0
0 1 1 1 1 1 1 1 1 1 1 1 1 6 1 1 1 1 1 1 1 1 1 1 1 1 1 1 1 1 1 1 1 1 1 1 1 1 1 0
0 2 2 2 2 2 2 2 2 2 2 2 2 5 2 2 2 2 2 2 2 2 1 1 1 1 1 1 1 1 1 1 1 1 1 1 1 1 1 0
0 2 1 1 1 1 4 1 1 1 1 1 1 1 1 1 1 1 1 1 4 2 1 1 1 1 1 1 1 1 1 1 1 1 1 1 1 1 1 0
0 2 1 2 5 2 1 2 2 2 2 2 2 5 2 2 2 2 2 2 1 2 1 1 1 1 1 1 1 1 1 1 1 1 1 1 1 1 1 0
0 2 1 2 11 2 1 2 4 1 1 1 1 1 1 1 1 1 4 2 1 2 1 1 1 1 1 1 1 1 1 1 1 1 1 1 1 1 1 0
0 2 1 2 11 2 1 2 1 2 2 2 2 5 2 2 2 2 1 2 1 2 1 1 1 1 1 1 1 1 1 1 1 1 1 1 1 1 1 0
0 2 1 2 11 2 1 2 1 2 4 1 1 1 1 1 4 2 1 2 1 2 1 1 1 1 1 1 1 1 1 1 1 1 1 1 1 1 1 0
0 2 1 2 11 2 1 2 1 2 1 2 2 5 2 2 1 2 1 2 1 2 1 1 1 1 1 1 1 1 1 1 1 1 1 1 1 1 1 0
0 2 1 2 11 2 5 2 5 2 5 2 5 5 5 2 5 2 5 2 5 2 1 1 1 1 1 1 1 1 1 1 1 1 1 1 1 1 1 0
0 2 1 2 11 2 11 2 11 2 11 2 11 11 11 2 11 2 11 2 11 2 1 1 1 1 1 1 1 1 1 1 1 1 1 1 1 1 1 0
0 2 1 2 11 2 5 2 5 2 5 2 5 5 5 2 5 2 5 2 5 2 1 1 1 1 1 1 1 1 1 1 1 1 1 1 1 1 1 0
0 2 1 2 11 2 1 2 1 2 1 2 2 2 2 2 1 2 1 2 1 2 1 1 1 1 1 1 1 1 1 1 1 1 1 1 1 1 1 0
0 2 1 2 11 2 1 2 1 2 4 1 1 1 1 1 4 2 1 2 1 2 1 1 1 1 1 1 1 1 1 1 1 1 1 1 1 1 1 0
0 2 1 2 4 2 1 2 1 2 2 2 2 2 2 2 2 2 1 2 1 2 1 1 1 1 1 1 1 1 1 1 1 1 1 1 1 1 1 0
0 2 1 2 4 2 1 2 4 1 1 1 1 1 1 1 1 1 4 2 1 2 1 1 1 1 1 1 1 1 1 1 1 1 1 1 1 1 1 0
0 2 1 2 4 2 1 2 2 2 2 2 2 2 2 2 2 2 2 2 1 2 1 1 1 1 1 1 1 1 1 1 1 1 1 1 1 1 1 0
0 2 1 2 4 2 4 1 1 1 1 1 1 1 1 1 1 1 1 1 4 2 1 1 1 1 1 1 1 1 1 1 1 1 1 1 1 1 1 0
0 2 2 2 2 2 2 2 2 2 2 2 2 2 2 2 2 2 2 2 2 2 1 1 1 1 1 1 1 1 1 1 1 1 1 1 1 1 1 0
0 1 1 1 1 1 1 1 1 1 1 1 1 1 1 1 1 1 1 1 1 1 1 1 1 1 1 1 1 1 1 1 1 1 1 1 1 1 1 0
0 1 1 1 1 1 1 1 1 1 1 1 1 1 1 1 1 1 1 1 1 1 1 1 1 1 1 1 1 1 1 1 1 1 1 1 1 1 10 0
0 0 0 0 0 0 0 0 0 0 0 0 0 0 0 0 0 0 0 0 0 0 0 0 0 0 0 0 0 0 0 0 0 0 0 0 0 0 0 0
